1000000010001000001000000100000000010000001010000000000000000000100000010000000000001000010000100000000001100000000000000000000000000010100100000000110000001001001000000100010000001010000000000000000000000010100000000000010000000100100000000000000000000001001000000001100000000000000000000010000000000000001000
0011100010001000010110010010000000000000001000000100000000010110010001000010000000001000001100000111000000010100000000000000100000000000001000000000000100100001101100011100000000000001000000000000100010000000000010001011010000000000000000010001000000000100001000010001001010010010000000011000010000100000110000
0010000000000100010000000000000100000000000000010000100000100000010000100000000001011000100001010000000011000100000101000000010000000010010001000000000001100000000100110010001010010001010000000000000001011000011000100000000001001001010000000110010000000001000000000000000001001100000000000000000010000000000000
0000000000000000001000100010000100000001000000000001100000000001000000000110000011010000000000101000000000001100011000000001100000100100100100000001000110001000110001000000000000000000001000011000000100000010000010000000000001010000001000000000000000100000110000010100000000010010000000000000000100000000000000
0000110000100000001000001110010000000100000000000010000001000000000001001000000001000010000000010000000100000011000000000110110100000000000000000001000000001010010000000100001000000110000011001000001100000001000000001000000000000000000100001001100000000010000000000001001000010110110001010100010001001101000000
0010001000000000000000000010000001011100010000000011000000000000001000000000000000000000100100011000001100011000001000000010000000000010000000000010000000000000000001110100000000000100000000000010100000010100000000000000000000000011000000101000010010000000000000111000000101000000000000101100110100010110000000
0011000000000000010000000101000100000000000000000000000000000000000000001100000100001000000000000010001000000000000000100000000000000011000000000100000100000000000000010010001000000110000000000100011000000000110000000000001100000000000101010000001000100000100010000010000100001000010001010010000001000000000010
0000000000000000011110010100000001000100000000100000000000000000010000000000001000001101100000000000000000000001000000000000010000000001100010000100000000000000000000000000100001000000001001000010000000000000110100000000000010000000001110000000000000001000010000111000000000100000001100100000000100010010000000
0010000100000001010000010010000000000000000000001100001000110000000000000100010100010010000001000000000010101100000001000000000000001100010100000000000000001000000110011000000000010000001000000000000010001010001000100000101000010001001000010011000010000010010000000000010010000100000100100000000000000000000000
0100000000000001000100000000000000000000010000000100000001000000000000000001000000001100000000000110000000001000100100000000000011000010000100000000000000100000101000000000000000001100100100000001000000000000000100000000000000001000000000010000000000000100000000010000001000001100011110011000000101100000000001
0000000001000000000001000010000011000010000100000100010010000000010000001000101001000001110000000100010100001000000000110000000000000000010100010000100000101010000000011000000010001000000000010000100100000001100100011000000000001100100110000000000100000010010010000100000000010000001000010000000100000000010001
0000010000000100010100000000100000001000000000001100011110010000010001000001000000000100011001000000000010100000001001100000000100110000000000000100011000000110100100000011000110010000000000010000000100000000100100100100000100000001001000010001000010000100000000011100010000000010000000000010000010000001000000
1000000000000000000001000010100010000000000000000000000000001001000001010000000000000000000000000011000000000111001010001010000000000000010000000000000101001000100000000100100000010000000010001010000000000000000101000000000000001001000000000000000000000000010000000000011110000100100111001000000000000000010010
0110000010000100000000000001000001000000000010010000000000000000010101011001001000100001001000110100101010000101100000100000000101000010000000000100000000000000001110100000000001010100100010000000000000000001000000100100100000000000101010000000000101001000000000000100000000000000010000011000000001000001001000
0000000001010000010000000000000001100010000000001100000100000000000000000000000000000000010000000000000000000000000100101000011010100001000000010000000000000110100001100000000100000000000001011100000000001000001010000000000000000100000010000110001000000100000000100000000000010000000000000010010000000100010100
0000100000000010000011000001111010100000010000100000100100010000010000001101100000100000000011100000110000000000010010000000000000100101000001000100001000000000000001001000000001000000010010000010000000000000000110100001000000000010001000000000010000000000000010000110000010000100001000100000100000000000100001
1010001000000000000001010000011000000000000000000000001000000001000001100000010000000001000000110000000000010000000000000000100001100000000000000000000000000000000100000000011000000100000000110000000101000001000010001001110100100001000010010100100011010101000010000000000000000100000101000101010001101000000000
1010001000001000000011000000100000000001101000100010100000110000000000000000010000000000100000010000100010100101100000010001000000101010100000010000001000001000001000000000000000000001001010000000000000100000010001000001010000000010000100001001000110000000010010010001001000000000100010000000000000000000000100
0100001000000000000000000000100001010000110000011100001010000000010000001010100000000000011000010010100000100000000000000010111000001000101001000000000000000000001000000000000000111000100000010000001000000000000001110101000000000000000000100100100100001000010000100000001100000000000000000010101000001100100100
1000000100000000000001100000000000000000000010000000000000000100000000000100001000001000001000000010000000000110010000000000000011000000000000000000000001000000000010010000000000100010010100000011000000000000100000001001010000000100010000000001010100000000100001000000000000000101001001001000010100010000000000
0010000001100001010001010000100000100000000000000000000001001000000000000000000001010001000010010000000001000000000000001001001100000000010000000000000000100000101001000010000001000101000010000100000000000000000000001010100111000010000000000010000010000011100010000000000001000001011000001000001000010000000011
0000000000001011000000000000000000000000000000010000010000000010000000100000000010000000000000000001010111010001010000000000010010000001000010000000100000000000001000000000010000000000000000100000001001000100000100011000000010100000000110000100100001001010000010000111001000010111000000000100000000000000000000
0011000000100000100101000000000000000000000000000010000000000000000000000010010001000001000100000000000010000100000001000100000000010000000000100011000000000000010000100000000001010010010001000000000010000010101000000010000100000000000000011100100000000001000000010000000000000000000100101000011001100100000001
0001000000001110010110000000000000000000000000000110000000000001000100000100100000101001100100010000000000100000000000000000000000000010000011100000000010001000001001100100010000000001100000000000000010000101010000010000001000000001010100000000000010010001000000000000000000000000000000000100000100000000000000
0010100000000010000000010000010001010010101000000000000000000010001100010100000001000100011000000100010100100000100101000000100000100000000000000010000000000000000100000000100000000000100001000100011000000100001000000000100000000010100001100001010000000000000000010000001000110110000000010000000000001000001011
0100000000000000010001010000010000000000000110000000000001000000000000000100000010010010000100000001011010000000000000001000100000100001000000000011000000000001000000000001000000000100100000110000000011001100001000000000000000001000000000000101000001000000101000010000000010000000100100101001100000010000001110
0000111000110100001000000100010010000000000000000000000010001000010100000000100000010000101000000010001000000001000110000100010000000000000100100000100000000010100001011000001000100100100000000001000000001000000000000000000000000100100000000000010000101010010000000000000001000000010000000000010100000000100010
0001000001110000100010100011010110001100000010000000000000000000000000000001001000000010000001000001000000001100000001000000010001000100000100000000100001000000001000001000000000100010000100010000000000000000000000001000110100000010010000000000000100000000000000000111000000100000000000000000100000100000000000
0000000100000010101010000000000010000100000000101000000000000000000000001010000000000000000011000000000100010000100100000100010000000000011000100101000000000100010000001010110000000000011100001100001000001000000110001000100100000010000001001100000001000100100000001000001001000001010100011000000010010001000101
1000100001100000110001100000000000100010000001100000001001000000001000010000010000010010010100000001100000011001000100100010010000000000000000001001001000000000000010000101111000000000000101000001000100010000100001000000000000110000100000010000000110100001000000001001100000101001100000100100000110000000010000
0110010101000000000111001001000010000010001000110000000000001010010100011100010000000000000100010001100000100000000001010000001000001100001110101000100001000000000000010001000010000001000001000000100000000000010000000000000000000000000000100000000000000000110000000000000100001100010001010001000000000000000000
0000000000101000000000010101000000000000010000000000000000000000011000000010000000100001000010000100100001001100010000011100000010001010100000000000000000001000010000000000000000000000000000010000000000000100000000010000001010011000001000000101000100000000000010010100001110000000000110000000000001111010000000
0000000000011000000000001010000000000000000000001000100000000001100000000000000001000110000000001010001000000000000000000000000100001101011011000000000100010001000000010100000010000000000000000000000000011000001000000010000000110000101100100001000011110000001000110000010011110010000000001000000100000000011000
0001001000100100000000001000000000110000000100000001010000000001010011100000000100100000001000010001010101000000000101000000100000000000000100000000010001000100000100000000000000000110010000000000000001100100000000100000000000001101000010010000000001000001000000010000000010000001000000100110001000000000000100
1000010001010010100000000001100000000000000001000100000000000000000010000000100000100000000000000000000100000000011100000110000100000001000000000001001000000010000100000000010010000001010100000010000010001000000000001000000100000000001000000000100000000000100000000100100010100100100100000000100001010000000010
0001000011000000000100000000001110101000000001001001100001000100000010000001100000000100011010000000000010000010011000000000011000000000000001100000001100100000000110001000110000000011010000000010001010000000000000000000000010000010000100001010000000000000000001000100001101000000000101000100000100001000001000
0000000000001010000000010100000000000000001000000100100000000010011001000000000000000000000000001000000100000000001011000100010000000000000000010111011100000000001000000000000100000011000000000000010010100111000010001010000000010011100100010000000000000100000100000000001000100100000000011000000001100000011000
0000000000100001000000000100000000000001100010000101100101010110000001000000010010000000000000000100000000100100001000100000100001000000010000000000100000000001000000001010000010000010010001110110110110100100001000000101010111000110000001001000001001001000000100010000000011001000000100000000000000000001000100
0000010001010010000001110010000100001001000000000000010000100000001011100000000000001010000000000000000111110000010000000000010000000000000101000010000000000000000000001000001000100010000000010000101000101100100100000001000000000000000000100000000100000101000010000000000010000100000000000000000000000001000000
1010000000000000000000000010010000000110100000000000010100010000000100000000000000100110000000001100000000010000000000100010010001100001000000000010010010010000000000100000100001001011000000001000000000100000000010000100000001010000000000000100001000000000000011000000000000000000001001010000000000000000000010
0000000000100000001000100000100001000000000000000001110000000000010000001101110000000000010000000000000010000000000100000111100010010000000101101010100000000000001000011000010000110000000010000000000000100000011000000100000000000001000000000000010000001000000000000001100000000000100010001001010000001000010000
1000000000010000001000001000000000000000000000000010000000000000100001001000001011000001000010000000000000000000000000000010000000000000001000000000100001100000000100010100000001000100000000000001000010000000001111000010000000001000000100000001000100000100000000110000111000001100100000000000111100011010000000
0000000001000100000001010000000001000101010001000000000000010110100000110000001000110000000000010010001000001100000000101010100000000000101010100000000001000000001000100000010001001100000000000010110001000100000000110000000000000001100000100000000010001000000101000010000000000001000010010000000000100011011000
0000000001000000001100000010010000000101000000001000110000010000000100100000000000000010000011000011101100000001000110000010000000010100000000010000000001000101000000001111001010101000000000000000011000000000100000000000000000001000000010000000000000000001001000001101000110000000001100001000000001100000000100
0000100101100100000001001000001000000100000000001000010000000000000010100101010000000000000000000001001100000010001000000000001010100000011000000000000000000001000000000100001000000100100000100000000000001000111011100100000001101110101000100010010000000000001010000000100001010000000000000001000011000000100000
0011000000000000000001000000001001011001100000000010001000000000000011000100000000010000001010000100010010001001000000010000000100000000000000100000000000001111001000000000010101010000010000110100100000000010010000000000100000001010001000000000011001000000100000000111000000000000000001000000000000000010000000
0000101000100010000000000001110000000001011010000000000000000000000011000000000000000000000000000010010000010101000010000000000000000000000001010001000001011000000000111010000111000000011100000000000000011010000000100000000000111010011000001000010010001000000000100000001101010101111000000010110001000000100100
0000000000010000001000100000010000000000000000001010100001000010100000001001000010000000001010000100000000000010000000000001001001000000001000000010000001000000001100110000110000000010000001000000000000000100100000100000000100010001000000000000100000100010100011001000101100000000010000000001001100000110010000
0100010000100110001010000000000001000110000001000000011000010000000000000100000110010000000001000100100000010000000001000000100001100000000000100010011000000000000000001011000000000000000001000000010011100010000000001000100001000000000011001000000010000000001100000000001100010000000000001000001100010000000000
0000000110001000000101000000000001100000000001100000100010000001000001011000000100000001101000000010001000010000000000001000100010000001000001010000110000001111000000011000000110000000000000000000000100000110000011001010000000000000111100000010001000010000000000100011110000001010000001000000001000000000000001