1000000010001000001000000100000000010000001010000000000000000000100000
0100000000000010000100001000000000011000000000000000000000000000101001
0000000011000000100100100000010001000000101000000000000000000000001010
0000000000010000000100100000000000000000000001001000000001100000000000
0000000000100000000000000010000011100010001000010110010010000000000000
0010000001000000000101100100010000100000000010000011000001110000000101
0000000000000010000000000000100000000000010010000110110001110000000000
0001000000000000100010000000000010001011010000000000000000010001000000
0001000010000100010010100100100000000110000100001000001100000010000000
0001000100000000000001000000000000000100001000001000000100001000000000
0101100010000101000000001100010000010100000001000000001001000100000000
0001100000000100110010001010010001010000000000000001011000011000100000
0000010010010100000001100100000000010000000000000000010011000000000000
0000001000000000000000000000000000000010001000100001000000010000000000
0110000000000100000000011000001101000000000010100000000000110001100000
0001100000100100100100000001000110001000110001000000000000000000001000
0110000001000000100000100000000000010100000010000000000000001000001100
0001010000000001001000000000000000010000000000000000001100001000000010
0000111001000000010000000000001000000100000000000100100000000100001000
0000010000000100000011000000000110110100000000000000000001000000001010
0100000001000010000001100000110010000011000000010000000010000000000000
0000010000100110000000001000000000000100100001011011000101010001000100
1101000000001000100000000000000000001000000101110001000000001100000000
0000001000000000000000000000100100011000001100011000001000000010000000
0000100000000000100000000000000000011101000000000001000000000000101000
0001010000000000000000000000001100000010100001001000000000000011100000
0101000000000000101100110100010110000000001100000000000001000000010100
0100000000000000000000000000000000000000001100000100001000000000000010
0010000000000000001000000000000000110000000001000001000000000000000100
1000100000011000000000010001100000000011000000000000110000000000010101
0000001000100000100010000010000100001000010001010010000001000000000010
0000000000000000011110010100000001000100000000100000000000000000010000
0000000010000011011000000000000000000000010000000000000100000000011000
1000010000000000000000000000000010000100000000100100001000000000000011
0100000000000010000000001110000000000000001000010000111000000000100000
0011001000000001000100100000000010000100000001010000010010000000000000
0000000011000010001100000000000001000101000100100000010000000000101011
0000000100000000000000110001010000000000000000100000011001100000000001
0000001000000000000010001010001000100000101000010001001000010011000010
0000100100000000000100100001000001001000000000000000000000000100000000
0000010001000000000000000000000100000001000000010000000000000000010000
0000110000000000011000000000100010010000000000001100001000010000000000
0000100000101000000000000000001100100100000001000000000000000100000000
0000000010000000000100000000000001000000000100000010000011000111100110
0000010110000000000100000000010000000000010000100000110000100001000001
0001001000000001000000100010100100000111000000010001010000100000000011
0000000000000000010100010000100000101010000000011000000010001000000000
0100001001000000011001000110000000000011001001100000000001000000100100
1000010000000001000000100001000000010000000001000100000100000001000101
0000000010000000100000000000110001111001000001000100000100000000010001